af-ZA-AdriNeural - Microsoft Adri Online (Natural) - Afrikaans (South Africa)
af-ZA-WillemNeural - Microsoft Willem Online (Natural) - Afrikaans (South Africa)
sq-AL-AnilaNeural - Microsoft Anila Online (Natural) - Albanian (Albania)
sq-AL-IlirNeural - Microsoft Ilir Online (Natural) - Albanian (Albania)
am-ET-AmehaNeural - Microsoft Ameha Online (Natural) - Amharic (Ethiopia)
am-ET-MekdesNeural - Microsoft Mekdes Online (Natural) - Amharic (Ethiopia)
ar-DZ-AminaNeural - Microsoft Amina Online (Natural) - Arabic (Algeria)
ar-DZ-IsmaelNeural - Microsoft Ismael Online (Natural) - Arabic (Algeria)
ar-BH-AliNeural - Microsoft Ali Online (Natural) - Arabic (Bahrain)
ar-BH-LailaNeural - Microsoft Laila Online (Natural) - Arabic (Bahrain)
ar-EG-SalmaNeural - Microsoft Salma Online (Natural) - Arabic (Egypt)
ar-EG-ShakirNeural - Microsoft Shakir Online (Natural) - Arabic (Egypt)
ar-IQ-BasselNeural - Microsoft Bassel Online (Natural) - Arabic (Iraq)
ar-IQ-RanaNeural - Microsoft Rana Online (Natural) - Arabic (Iraq)
ar-JO-SanaNeural - Microsoft Sana Online (Natural) - Arabic (Jordan)
ar-JO-TaimNeural - Microsoft Taim Online (Natural) - Arabic (Jordan)
ar-KW-FahedNeural - Microsoft Fahed Online (Natural) - Arabic (Kuwait)
ar-KW-NouraNeural - Microsoft Noura Online (Natural) - Arabic (Kuwait)
ar-LB-LaylaNeural - Microsoft Layla Online (Natural) - Arabic (Lebanon)
ar-LB-RamiNeural - Microsoft Rami Online (Natural) - Arabic (Lebanon)
ar-LY-ImanNeural - Microsoft Iman Online (Natural) - Arabic (Libya)
ar-LY-OmarNeural - Microsoft Omar Online (Natural) - Arabic (Libya)
ar-MA-JamalNeural - Microsoft Jamal Online (Natural) - Arabic (Morocco)
ar-MA-MounaNeural - Microsoft Mouna Online (Natural) - Arabic (Morocco)
ar-OM-AbdullahNeural - Microsoft Abdullah Online (Natural) - Arabic (Oman)
ar-OM-AyshaNeural - Microsoft Aysha Online (Natural) - Arabic (Oman)
ar-QA-AmalNeural - Microsoft Amal Online (Natural) - Arabic (Qatar)
ar-QA-MoazNeural - Microsoft Moaz Online (Natural) - Arabic (Qatar)
ar-SA-HamedNeural - Microsoft Hamed Online (Natural) - Arabic (Saudi Arabia)
ar-SA-ZariyahNeural - Microsoft Zariyah Online (Natural) - Arabic (Saudi Arabia)
ar-SY-AmanyNeural - Microsoft Amany Online (Natural) - Arabic (Syria)
ar-SY-LaithNeural - Microsoft Laith Online (Natural) - Arabic (Syria)
ar-TN-HediNeural - Microsoft Hedi Online (Natural) - Arabic (Tunisia)
ar-TN-ReemNeural - Microsoft Reem Online (Natural) - Arabic (Tunisia)
ar-AE-FatimaNeural - Microsoft Fatima Online (Natural) - Arabic (United Arab Emirates)
ar-AE-HamdanNeural - Microsoft Hamdan Online (Natural) - Arabic (United Arab Emirates)
ar-YE-MaryamNeural - Microsoft Maryam Online (Natural) - Arabic (Yemen)
ar-YE-SalehNeural - Microsoft Saleh Online (Natural) - Arabic (Yemen)
az-AZ-BabekNeural - Microsoft Babek Online (Natural) - Azerbaijani (Azerbaijan)
az-AZ-BanuNeural - Microsoft Banu Online (Natural) - Azerbaijani (Azerbaijan)
bn-BD-NabanitaNeural - Microsoft Nabanita Online (Natural) - Bangla (Bangladesh)
bn-BD-PradeepNeural - Microsoft Pradeep Online (Natural) - Bangla (Bangladesh)
bn-IN-BashkarNeural - Microsoft Bashkar Online (Natural) - Bangla (India)
bn-IN-TanishaaNeural - Microsoft Tanishaa Online (Natural) - Bengali (India)
bs-BA-VesnaNeural - Microsoft Vesna Online (Natural) - Bosnian (Bosnia and Herzegovina)
bs-BA-GoranNeural - Microsoft Goran Online (Natural) - Bosnian (Bosnia)
bg-BG-BorislavNeural - Microsoft Borislav Online (Natural) - Bulgarian (Bulgaria)
bg-BG-KalinaNeural - Microsoft Kalina Online (Natural) - Bulgarian (Bulgaria)
my-MM-NilarNeural - Microsoft Nilar Online (Natural) - Burmese (Myanmar)
my-MM-ThihaNeural - Microsoft Thiha Online (Natural) - Burmese (Myanmar)
ca-ES-EnricNeural - Microsoft Enric Online (Natural) - Catalan
ca-ES-JoanaNeural - Microsoft Joana Online (Natural) - Catalan
zh-HK-HiuGaaiNeural - Microsoft HiuGaai Online (Natural) - Chinese (Cantonese Traditional)
zh-HK-HiuMaanNeural - Microsoft HiuMaan Online (Natural) - Chinese (Hong Kong SAR)
zh-HK-WanLungNeural - Microsoft WanLung Online (Natural) - Chinese (Hong Kong SAR)
zh-CN-XiaoxiaoNeural - Microsoft Xiaoxiao Online (Natural) - Chinese (Mainland)
zh-CN-XiaoyiNeural - Microsoft Xiaoyi Online (Natural) - Chinese (Mainland)
zh-CN-YunjianNeural - Microsoft Yunjian Online (Natural) - Chinese (Mainland)
zh-CN-YunxiNeural - Microsoft Yunxi Online (Natural) - Chinese (Mainland)
zh-CN-YunxiaNeural - Microsoft Yunxia Online (Natural) - Chinese (Mainland)
zh-CN-YunyangNeural - Microsoft Yunyang Online (Natural) - Chinese (Mainland)
zh-CN-liaoning-XiaobeiNeural - Microsoft Xiaobei Online (Natural) - Chinese (Northeastern Mandarin)
zh-TW-HsiaoChenNeural - Microsoft HsiaoChen Online (Natural) - Chinese (Taiwan)
zh-TW-YunJheNeural - Microsoft YunJhe Online (Natural) - Chinese (Taiwan)
zh-TW-HsiaoYuNeural - Microsoft HsiaoYu Online (Natural) - Chinese (Taiwanese Mandarin)
zh-CN-shaanxi-XiaoniNeural - Microsoft Xiaoni Online (Natural) - Chinese (Zhongyuan Mandarin Shaanxi)
hr-HR-GabrijelaNeural - Microsoft Gabrijela Online (Natural) - Croatian (Croatia)
hr-HR-SreckoNeural - Microsoft Srecko Online (Natural) - Croatian (Croatia)
cs-CZ-AntoninNeural - Microsoft Antonin Online (Natural) - Czech (Czech)
cs-CZ-VlastaNeural - Microsoft Vlasta Online (Natural) - Czech (Czech)
da-DK-ChristelNeural - Microsoft Christel Online (Natural) - Danish (Denmark)
da-DK-JeppeNeural - Microsoft Jeppe Online (Natural) - Danish (Denmark)
nl-BE-ArnaudNeural - Microsoft Arnaud Online (Natural) - Dutch (Belgium)
nl-BE-DenaNeural - Microsoft Dena Online (Natural) - Dutch (Belgium)
nl-NL-ColetteNeural - Microsoft Colette Online (Natural) - Dutch (Netherlands)
nl-NL-FennaNeural - Microsoft Fenna Online (Natural) - Dutch (Netherlands)
nl-NL-MaartenNeural - Microsoft Maarten Online (Natural) - Dutch (Netherlands)
en-AU-WilliamMultilingualNeural - Microsoft WilliamMultilingual Online (Natural) - English (Australia)
en-AU-NatashaNeural - Microsoft Natasha Online (Natural) - English (Australia)
en-CA-ClaraNeural - Microsoft Clara Online (Natural) - English (Canada)
en-CA-LiamNeural - Microsoft Liam Online (Natural) - English (Canada)
en-HK-YanNeural - Microsoft Yan Online (Natural) - English (Hong Kong SAR)
en-HK-SamNeural - Microsoft Sam Online (Natural) - English (Hongkong)
en-IN-NeerjaExpressiveNeural - Microsoft Neerja Online (Natural) - English (India) (Preview)
en-IN-NeerjaNeural - Microsoft Neerja Online (Natural) - English (India)
en-IN-PrabhatNeural - Microsoft Prabhat Online (Natural) - English (India)
en-IE-ConnorNeural - Microsoft Connor Online (Natural) - English (Ireland)
en-IE-EmilyNeural - Microsoft Emily Online (Natural) - English (Ireland)
en-KE-AsiliaNeural - Microsoft Asilia Online (Natural) - English (Kenya)
en-KE-ChilembaNeural - Microsoft Chilemba Online (Natural) - English (Kenya)
en-NZ-MitchellNeural - Microsoft Mitchell Online (Natural) - English (New Zealand)
en-NZ-MollyNeural - Microsoft Molly Online (Natural) - English (New Zealand)
en-NG-AbeoNeural - Microsoft Abeo Online (Natural) - English (Nigeria)
en-NG-EzinneNeural - Microsoft Ezinne Online (Natural) - English (Nigeria)
en-PH-JamesNeural - Microsoft James Online (Natural) - English (Philippines)
en-PH-RosaNeural - Microsoft Rosa Online (Natural) - English (Philippines)
en-US-AvaNeural - Microsoft Ava Online (Natural) - English (United States)
en-US-AndrewNeural - Microsoft Andrew Online (Natural) - English (United States)
en-US-EmmaNeural - Microsoft Emma Online (Natural) - English (United States)
en-US-BrianNeural - Microsoft Brian Online (Natural) - English (United States)
en-SG-LunaNeural - Microsoft Luna Online (Natural) - English (Singapore)
en-SG-WayneNeural - Microsoft Wayne Online (Natural) - English (Singapore)
en-ZA-LeahNeural - Microsoft Leah Online (Natural) - English (South Africa)
en-ZA-LukeNeural - Microsoft Luke Online (Natural) - English (South Africa)
en-TZ-ElimuNeural - Microsoft Elimu Online (Natural) - English (Tanzania)
en-TZ-ImaniNeural - Microsoft Imani Online (Natural) - English (Tanzania)
en-GB-LibbyNeural - Microsoft Libby Online (Natural) - English (United Kingdom)
en-GB-MaisieNeural - Microsoft Maisie Online (Natural) - English (United Kingdom)
en-GB-RyanNeural - Microsoft Ryan Online (Natural) - English (United Kingdom)
en-GB-SoniaNeural - Microsoft Sonia Online (Natural) - English (United Kingdom)
en-GB-ThomasNeural - Microsoft Thomas Online (Natural) - English (United Kingdom)
en-US-AnaNeural - Microsoft Ana Online (Natural) - English (United States)
en-US-AndrewMultilingualNeural - Microsoft AndrewMultilingual Online (Natural) - English (United States)
en-US-AriaNeural - Microsoft Aria Online (Natural) - English (United States)
en-US-AvaMultilingualNeural - Microsoft AvaMultilingual Online (Natural) - English (United States)
en-US-BrianMultilingualNeural - Microsoft BrianMultilingual Online (Natural) - English (United States)
en-US-ChristopherNeural - Microsoft Christopher Online (Natural) - English (United States)
en-US-EmmaMultilingualNeural - Microsoft EmmaMultilingual Online (Natural) - English (United States)
en-US-EricNeural - Microsoft Eric Online (Natural) - English (United States)
en-US-GuyNeural - Microsoft Guy Online (Natural) - English (United States)
en-US-JennyNeural - Microsoft Jenny Online (Natural) - English (United States)
en-US-MichelleNeural - Microsoft Michelle Online (Natural) - English (United States)
en-US-RogerNeural - Microsoft Roger Online (Natural) - English (United States)
en-US-SteffanNeural - Microsoft Steffan Online (Natural) - English (United States)
et-EE-AnuNeural - Microsoft Anu Online (Natural) - Estonian (Estonia)
et-EE-KertNeural - Microsoft Kert Online (Natural) - Estonian (Estonia)
fil-PH-AngeloNeural - Microsoft Angelo Online (Natural) - Filipino (Philippines)
fil-PH-BlessicaNeural - Microsoft Blessica Online (Natural) - Filipino (Philippines)
fi-FI-HarriNeural - Microsoft Harri Online (Natural) - Finnish (Finland)
fi-FI-NooraNeural - Microsoft Noora Online (Natural) - Finnish (Finland)
fr-BE-CharlineNeural - Microsoft Charline Online (Natural) - French (Belgium)
fr-BE-GerardNeural - Microsoft Gerard Online (Natural) - French (Belgium)
fr-CA-ThierryNeural - Microsoft Thierry Online (Natural) - French (Canada)
fr-CA-AntoineNeural - Microsoft Antoine Online (Natural) - French (Canada)
fr-CA-JeanNeural - Microsoft Jean Online (Natural) - French (Canada)
fr-CA-SylvieNeural - Microsoft Sylvie Online (Natural) - French (Canada)
fr-FR-VivienneMultilingualNeural - Microsoft VivienneMultilingual Online (Natural) - French (France)
fr-FR-RemyMultilingualNeural - Microsoft RemyMultilingual Online (Natural) - French (France)
fr-FR-DeniseNeural - Microsoft Denise Online (Natural) - French (France)
fr-FR-EloiseNeural - Microsoft Eloise Online (Natural) - French (France)
fr-FR-HenriNeural - Microsoft Henri Online (Natural) - French (France)
fr-CH-ArianeNeural - Microsoft Ariane Online (Natural) - French (Switzerland)
fr-CH-FabriceNeural - Microsoft Fabrice Online (Natural) - French (Switzerland)
gl-ES-RoiNeural - Microsoft Roi Online (Natural) - Galician
gl-ES-SabelaNeural - Microsoft Sabela Online (Natural) - Galician
ka-GE-EkaNeural - Microsoft Eka Online (Natural) - Georgian (Georgia)
ka-GE-GiorgiNeural - Microsoft Giorgi Online (Natural) - Georgian (Georgia)
de-AT-IngridNeural - Microsoft Ingrid Online (Natural) - German (Austria)
de-AT-JonasNeural - Microsoft Jonas Online (Natural) - German (Austria)
de-DE-SeraphinaMultilingualNeural - Microsoft SeraphinaMultilingual Online (Natural) - German (Germany)
de-DE-FlorianMultilingualNeural - Microsoft FlorianMultilingual Online (Natural) - German (Germany)
de-DE-AmalaNeural - Microsoft Amala Online (Natural) - German (Germany)
de-DE-ConradNeural - Microsoft Conrad Online (Natural) - German (Germany)
de-DE-KatjaNeural - Microsoft Katja Online (Natural) - German (Germany)
de-DE-KillianNeural - Microsoft Killian Online (Natural) - German (Germany)
de-CH-JanNeural - Microsoft Jan Online (Natural) - German (Switzerland)
de-CH-LeniNeural - Microsoft Leni Online (Natural) - German (Switzerland)
el-GR-AthinaNeural - Microsoft Athina Online (Natural) - Greek (Greece)
el-GR-NestorasNeural - Microsoft Nestoras Online (Natural) - Greek (Greece)
gu-IN-DhwaniNeural - Microsoft Dhwani Online (Natural) - Gujarati (India)
gu-IN-NiranjanNeural - Microsoft Niranjan Online (Natural) - Gujarati (India)
he-IL-AvriNeural - Microsoft Avri Online (Natural) - Hebrew (Israel)
he-IL-HilaNeural - Microsoft Hila Online (Natural) - Hebrew (Israel)
hi-IN-MadhurNeural - Microsoft Madhur Online (Natural) - Hindi (India)
hi-IN-SwaraNeural - Microsoft Swara Online (Natural) - Hindi (India)
hu-HU-NoemiNeural - Microsoft Noemi Online (Natural) - Hungarian (Hungary)
hu-HU-TamasNeural - Microsoft Tamas Online (Natural) - Hungarian (Hungary)
is-IS-GudrunNeural - Microsoft Gudrun Online (Natural) - Icelandic (Iceland)
is-IS-GunnarNeural - Microsoft Gunnar Online (Natural) - Icelandic (Iceland)
id-ID-ArdiNeural - Microsoft Ardi Online (Natural) - Indonesian (Indonesia)
id-ID-GadisNeural - Microsoft Gadis Online (Natural) - Indonesian (Indonesia)
iu-Latn-CA-SiqiniqNeural - Microsoft Siqiniq Online (Natural) - Inuktitut (Latin, Canada)
iu-Latn-CA-TaqqiqNeural - Microsoft Taqqiq Online (Natural) - Inuktitut (Latin, Canada)
iu-Cans-CA-SiqiniqNeural - Microsoft Siqiniq Online (Natural) - Inuktitut (Syllabics, Canada)
iu-Cans-CA-TaqqiqNeural - Microsoft Taqqiq Online (Natural) - Inuktitut (Syllabics, Canada)
ga-IE-ColmNeural - Microsoft Colm Online (Natural) - Irish (Ireland)
ga-IE-OrlaNeural - Microsoft Orla Online (Natural) - Irish (Ireland)
it-IT-GiuseppeMultilingualNeural - Microsoft GiuseppeMultilingual Online (Natural) - Italian (Italy)
it-IT-DiegoNeural - Microsoft Diego Online (Natural) - Italian (Italy)
it-IT-ElsaNeural - Microsoft Elsa Online (Natural) - Italian (Italy)
it-IT-IsabellaNeural - Microsoft Isabella Online (Natural) - Italian (Italy)
ja-JP-KeitaNeural - Microsoft Keita Online (Natural) - Japanese (Japan)
ja-JP-NanamiNeural - Microsoft Nanami Online (Natural) - Japanese (Japan)
jv-ID-DimasNeural - Microsoft Dimas Online (Natural) - Javanese (Indonesia)
jv-ID-SitiNeural - Microsoft Siti Online (Natural) - Javanese (Indonesia)
kn-IN-GaganNeural - Microsoft Gagan Online (Natural) - Kannada (India)
kn-IN-SapnaNeural - Microsoft Sapna Online (Natural) - Kannada (India)
kk-KZ-AigulNeural - Microsoft Aigul Online (Natural) - Kazakh (Kazakhstan)
kk-KZ-DauletNeural - Microsoft Daulet Online (Natural) - Kazakh (Kazakhstan)
km-KH-PisethNeural - Microsoft Piseth Online (Natural) - Khmer (Cambodia)
km-KH-SreymomNeural - Microsoft Sreymom Online (Natural) - Khmer (Cambodia)
ko-KR-HyunsuMultilingualNeural - Microsoft HyunsuMultilingual Online (Natural) - Korean (Korea)
ko-KR-InJoonNeural - Microsoft InJoon Online (Natural) - Korean (Korea)
ko-KR-SunHiNeural - Microsoft SunHi Online (Natural) - Korean (Korea)
lo-LA-ChanthavongNeural - Microsoft Chanthavong Online (Natural) - Lao (Laos)
lo-LA-KeomanyNeural - Microsoft Keomany Online (Natural) - Lao (Laos)
lv-LV-EveritaNeural - Microsoft Everita Online (Natural) - Latvian (Latvia)
lv-LV-NilsNeural - Microsoft Nils Online (Natural) - Latvian (Latvia)
lt-LT-LeonasNeural - Microsoft Leonas Online (Natural) - Lithuanian (Lithuania)
lt-LT-OnaNeural - Microsoft Ona Online (Natural) - Lithuanian (Lithuania)
mk-MK-AleksandarNeural - Microsoft Aleksandar Online (Natural) - Macedonian (North Macedonia)
mk-MK-MarijaNeural - Microsoft Marija Online (Natural) - Macedonian (North Macedonia)
ms-MY-OsmanNeural - Microsoft Osman Online (Natural) - Malay (Malaysia)
ms-MY-YasminNeural - Microsoft Yasmin Online (Natural) - Malay (Malaysia)
ml-IN-MidhunNeural - Microsoft Midhun Online (Natural) - Malayalam (India)
ml-IN-SobhanaNeural - Microsoft Sobhana Online (Natural) - Malayalam (India)
mt-MT-GraceNeural - Microsoft Grace Online (Natural) - Maltese (Malta)
mt-MT-JosephNeural - Microsoft Joseph Online (Natural) - Maltese (Malta)
mr-IN-AarohiNeural - Microsoft Aarohi Online (Natural) - Marathi (India)
mr-IN-ManoharNeural - Microsoft Manohar Online (Natural) - Marathi (India)
mn-MN-BataaNeural - Microsoft Bataa Online (Natural) - Mongolian (Mongolia)
mn-MN-YesuiNeural - Microsoft Yesui Online (Natural) - Mongolian (Mongolia)
ne-NP-HemkalaNeural - Microsoft Hemkala Online (Natural) - Nepali (Nepal)
ne-NP-SagarNeural - Microsoft Sagar Online (Natural) - Nepali (Nepal)
nb-NO-FinnNeural - Microsoft Finn Online (Natural) - Norwegian (Bokmål Norway)
nb-NO-PernilleNeural - Microsoft Pernille Online (Natural) - Norwegian (Bokmål, Norway)
ps-AF-GulNawazNeural - Microsoft GulNawaz Online (Natural) - Pashto (Afghanistan)
ps-AF-LatifaNeural - Microsoft Latifa Online (Natural) - Pashto (Afghanistan)
fa-IR-DilaraNeural - Microsoft Dilara Online (Natural) - Persian (Iran)
fa-IR-FaridNeural - Microsoft Farid Online (Natural) - Persian (Iran)
pl-PL-MarekNeural - Microsoft Marek Online (Natural) - Polish (Poland)
pl-PL-ZofiaNeural - Microsoft Zofia Online (Natural) - Polish (Poland)
pt-BR-ThalitaMultilingualNeural - Microsoft ThalitaMultilingual Online (Natural) - Portuguese (Brazil)
pt-BR-AntonioNeural - Microsoft Antonio Online (Natural) - Portuguese (Brazil)
pt-BR-FranciscaNeural - Microsoft Francisca Online (Natural) - Portuguese (Brazil)
pt-PT-DuarteNeural - Microsoft Duarte Online (Natural) - Portuguese (Portugal)
pt-PT-RaquelNeural - Microsoft Raquel Online (Natural) - Portuguese (Portugal)
ro-RO-AlinaNeural - Microsoft Alina Online (Natural) - Romanian (Romania)
ro-RO-EmilNeural - Microsoft Emil Online (Natural) - Romanian (Romania)
ru-RU-DmitryNeural - Microsoft Dmitry Online (Natural) - Russian (Russia)
ru-RU-SvetlanaNeural - Microsoft Svetlana Online (Natural) - Russian (Russia)
sr-RS-NicholasNeural - Microsoft Nicholas Online (Natural) - Serbian (Serbia)
sr-RS-SophieNeural - Microsoft Sophie Online (Natural) - Serbian (Serbia)
si-LK-SameeraNeural - Microsoft Sameera Online (Natural) - Sinhala (Sri Lanka)
si-LK-ThiliniNeural - Microsoft Thilini Online (Natural) - Sinhala (Sri Lanka)
sk-SK-LukasNeural - Microsoft Lukas Online (Natural) - Slovak (Slovakia)
sk-SK-ViktoriaNeural - Microsoft Viktoria Online (Natural) - Slovak (Slovakia)
sl-SI-PetraNeural - Microsoft Petra Online (Natural) - Slovenian (Slovenia)
sl-SI-RokNeural - Microsoft Rok Online (Natural) - Slovenian (Slovenia)
so-SO-MuuseNeural - Microsoft Muuse Online (Natural) - Somali (Somalia)
so-SO-UbaxNeural - Microsoft Ubax Online (Natural) - Somali (Somalia)
es-AR-ElenaNeural - Microsoft Elena Online (Natural) - Spanish (Argentina)
es-AR-TomasNeural - Microsoft Tomas Online (Natural) - Spanish (Argentina)
es-BO-MarceloNeural - Microsoft Marcelo Online (Natural) - Spanish (Bolivia)
es-BO-SofiaNeural - Microsoft Sofia Online (Natural) - Spanish (Bolivia)
es-CL-CatalinaNeural - Microsoft Catalina Online (Natural) - Spanish (Chile)
es-CL-LorenzoNeural - Microsoft Lorenzo Online (Natural) - Spanish (Chile)
es-CO-GonzaloNeural - Microsoft Gonzalo Online (Natural) - Spanish (Colombia)
es-CO-SalomeNeural - Microsoft Salome Online (Natural) - Spanish (Colombia)
es-ES-XimenaNeural - Microsoft Ximena Online (Natural) - Spanish (Colombia)
es-CR-JuanNeural - Microsoft Juan Online (Natural) - Spanish (Costa Rica)
es-CR-MariaNeural - Microsoft Maria Online (Natural) - Spanish (Costa Rica)
es-CU-BelkysNeural - Microsoft Belkys Online (Natural) - Spanish (Cuba)
es-CU-ManuelNeural - Microsoft Manuel Online (Natural) - Spanish (Cuba)
es-DO-EmilioNeural - Microsoft Emilio Online (Natural) - Spanish (Dominican Republic)
es-DO-RamonaNeural - Microsoft Ramona Online (Natural) - Spanish (Dominican Republic)
es-EC-AndreaNeural - Microsoft Andrea Online (Natural) - Spanish (Ecuador)
es-EC-LuisNeural - Microsoft Luis Online (Natural) - Spanish (Ecuador)
es-SV-LorenaNeural - Microsoft Lorena Online (Natural) - Spanish (El Salvador)
es-SV-RodrigoNeural - Microsoft Rodrigo Online (Natural) - Spanish (El Salvador)
es-GQ-JavierNeural - Microsoft Javier Online (Natural) - Spanish (Equatorial Guinea)
es-GQ-TeresaNeural - Microsoft Teresa Online (Natural) - Spanish (Equatorial Guinea)
es-GT-AndresNeural - Microsoft Andres Online (Natural) - Spanish (Guatemala)
es-GT-MartaNeural - Microsoft Marta Online (Natural) - Spanish (Guatemala)
es-HN-CarlosNeural - Microsoft Carlos Online (Natural) - Spanish (Honduras)
es-HN-KarlaNeural - Microsoft Karla Online (Natural) - Spanish (Honduras)
es-MX-DaliaNeural - Microsoft Dalia Online (Natural) - Spanish (Mexico)
es-MX-JorgeNeural - Microsoft Jorge Online (Natural) - Spanish (Mexico)
es-NI-FedericoNeural - Microsoft Federico Online (Natural) - Spanish (Nicaragua)
es-NI-YolandaNeural - Microsoft Yolanda Online (Natural) - Spanish (Nicaragua)
es-PA-MargaritaNeural - Microsoft Margarita Online (Natural) - Spanish (Panama)
es-PA-RobertoNeural - Microsoft Roberto Online (Natural) - Spanish (Panama)
es-PY-MarioNeural - Microsoft Mario Online (Natural) - Spanish (Paraguay)
es-PY-TaniaNeural - Microsoft Tania Online (Natural) - Spanish (Paraguay)
es-PE-AlexNeural - Microsoft Alex Online (Natural) - Spanish (Peru)
es-PE-CamilaNeural - Microsoft Camila Online (Natural) - Spanish (Peru)
es-PR-KarinaNeural - Microsoft Karina Online (Natural) - Spanish (Puerto Rico)
es-PR-VictorNeural - Microsoft Victor Online (Natural) - Spanish (Puerto Rico)
es-ES-AlvaroNeural - Microsoft Alvaro Online (Natural) - Spanish (Spain)
es-ES-ElviraNeural - Microsoft Elvira Online (Natural) - Spanish (Spain)
es-US-AlonsoNeural - Microsoft Alonso Online (Natural) - Spanish (United States)
es-US-PalomaNeural - Microsoft Paloma Online (Natural) - Spanish (United States)
es-UY-MateoNeural - Microsoft Mateo Online (Natural) - Spanish (Uruguay)
es-UY-ValentinaNeural - Microsoft Valentina Online (Natural) - Spanish (Uruguay)
es-VE-PaolaNeural - Microsoft Paola Online (Natural) - Spanish (Venezuela)
es-VE-SebastianNeural - Microsoft Sebastian Online (Natural) - Spanish (Venezuela)
su-ID-JajangNeural - Microsoft Jajang Online (Natural) - Sundanese (Indonesia)
su-ID-TutiNeural - Microsoft Tuti Online (Natural) - Sundanese (Indonesia)
sw-KE-RafikiNeural - Microsoft Rafiki Online (Natural) - Swahili (Kenya)
sw-KE-ZuriNeural - Microsoft Zuri Online (Natural) - Swahili (Kenya)
sw-TZ-DaudiNeural - Microsoft Daudi Online (Natural) - Swahili (Tanzania)
sw-TZ-RehemaNeural - Microsoft Rehema Online (Natural) - Swahili (Tanzania)
sv-SE-MattiasNeural - Microsoft Mattias Online (Natural) - Swedish (Sweden)
sv-SE-SofieNeural - Microsoft Sofie Online (Natural) - Swedish (Sweden)
ta-IN-PallaviNeural - Microsoft Pallavi Online (Natural) - Tamil (India)
ta-IN-ValluvarNeural - Microsoft Valluvar Online (Natural) - Tamil (India)
ta-MY-KaniNeural - Microsoft Kani Online (Natural) - Tamil (Malaysia)
ta-MY-SuryaNeural - Microsoft Surya Online (Natural) - Tamil (Malaysia)
ta-SG-AnbuNeural - Microsoft Anbu Online (Natural) - Tamil (Singapore)
ta-SG-VenbaNeural - Microsoft Venba Online (Natural) - Tamil (Singapore)
ta-LK-KumarNeural - Microsoft Kumar Online (Natural) - Tamil (Sri Lanka)
ta-LK-SaranyaNeural - Microsoft Saranya Online (Natural) - Tamil (Sri Lanka)
te-IN-MohanNeural - Microsoft Mohan Online (Natural) - Telugu (India)
te-IN-ShrutiNeural - Microsoft Shruti Online (Natural) - Telugu (India)
th-TH-NiwatNeural - Microsoft Niwat Online (Natural) - Thai (Thailand)
th-TH-PremwadeeNeural - Microsoft Premwadee Online (Natural) - Thai (Thailand)
tr-TR-EmelNeural - Microsoft Emel Online (Natural) - Turkish (Turkey)
tr-TR-AhmetNeural - Microsoft Ahmet Online (Natural) - Turkish (Türkiye)
uk-UA-OstapNeural - Microsoft Ostap Online (Natural) - Ukrainian (Ukraine)
uk-UA-PolinaNeural - Microsoft Polina Online (Natural) - Ukrainian (Ukraine)
ur-IN-GulNeural - Microsoft Gul Online (Natural) - Urdu (India)
ur-IN-SalmanNeural - Microsoft Salman Online (Natural) - Urdu (India)
ur-PK-AsadNeural - Microsoft Asad Online (Natural) - Urdu (Pakistan)
ur-PK-UzmaNeural - Microsoft Uzma Online (Natural) - Urdu (Pakistan)
uz-UZ-MadinaNeural - Microsoft Madina Online (Natural) - Uzbek (Uzbekistan)
uz-UZ-SardorNeural - Microsoft Sardor Online (Natural) - Uzbek (Uzbekistan)
vi-VN-HoaiMyNeural - Microsoft HoaiMy Online (Natural) - Vietnamese (Vietnam)
vi-VN-NamMinhNeural - Microsoft NamMinh Online (Natural) - Vietnamese (Vietnam)
cy-GB-AledNeural - Microsoft Aled Online (Natural) - Welsh (United Kingdom)
cy-GB-NiaNeural - Microsoft Nia Online (Natural) - Welsh (United Kingdom)
zu-ZA-ThandoNeural - Microsoft Thando Online (Natural) - Zulu (South Africa)
zu-ZA-ThembaNeural - Microsoft Themba Online (Natural) - Zulu (South Africa)
